111111111011111
10000C0001
1P000000E1
1111111111111