1111111111111111111111111111111
10P0000001000000000000000100001
100000000100100000000000000E001
1000000000000000C00000000111111
1000000001000000000000000000001
1000000001000000000000000000001
1000000C0000000C000000000000001
1111111111111111111111111111111