1111111111
101P1C0001
100100E111
1111111111